1111111
10C00E1
1000011
1000001
1000001
10000P1
1111111