1111111111111
1000000000001
1000000000001
1000000000001
110000000E011
1000000000001
1000000000001
1000000000001
1000000000001
1000000000001
1000000000001
1000000000001
1000000C00001
1000000000001
1000000000001
1000000000001
1000000000P01
1C00000000001
1111111111111