111111111111
1001P0000001
100111100001
1110E0000001
1C0000000001
111000000001
111111111111