11111111
1001PC01
10000001
10000001
10E00001
11111111