1111111111111
10000000000E1
1000010010011
1000000000001
1111011011011
1000000000001
1000000000001
1000000000001
1000000000001
10C0000000001
1000000000001
1000000000001
1000000000001
1000000000001
1000000000001
1000000000001
1000000000001
10000000000P1
1111111111111