1111111
1PC00E1
1000011
1000001
1111C11
1000001
1111111