11111111111111111
1001PE00000000011
10011110000101111
10011110000111111
1C00000001C111111
11100000010111111
11111111111111111