1111111111111
1P010000000C1
1000011111001
100011E00C001
1111111111111