1111111111111111111111111111111111
1E0000000000000C00000C000000000011


