1111111
1000CE1
1111C11
1000001
1100001
10000P1
1111111