1111111
10000E1
1100C11
1000011
1000001
10000P1
1111111