1111111
10000E1
1100011
10CP101
1100001
10000P1
1111111