1111111111111
10P00C0000001
1000000000001
10000E0000001
1111111111111