1111111
10000E1
1100C11
1000001
1100001
10000P1
1111111