111111111111111
1E0000C00000C01
101001010010101
101001001010101
1P000C00C0000C1
111111111111111